# Asynchrony

Asynchrony	KEYWORD1
Listener	KEYWORD1
identificator	KEYWORD1
Asyn	KEYWORD2
loop	KEYWORD2
add	KEYWORD2
remove	KEYWORD2

UNDEFINED	LITERAL1
DEFAULT_BOUNCE	LITERAL1
SECOND	LITERAL1
MILLISECOND	LITERAL1
MICROSECOND	LITERAL1


# Listeners

Click	KEYWORD1
click	KEYWORD2
Interval	KEYWORD1
interval	KEYWORD2
Timeout	KEYWORD1
timeout	KEYWORD2